0000110000
0000110000
0001221000
0001221000
0012332100
0012332100
0123003210
0123003210
1233333321
1111111111

1111111111
1222222221
1233333321
1230000321
1230330321
1230330321
1230000321
1233333321
1222222221
1111111111

0000110000
0000220000
0000330000
0000330000
1233333321
1233333321
0000330000
0000330000
0000220000
0000110000

0000110000
0001221000
0012332100
0123003210
1230000321
1230000321
0123003210
0012332100
0001221000
0000110000

1000000001
1200000021
1230000321
1230000321
1233333321
1233333321
1230000321
1230000321
1200000021
1000000001
